111111111
10C00C0E1
110C01111
1P01C00C1
111111111