11111111111
11111111111
100C00C0E01
1110C011111
10P01000C01
10001C00001
11111111111
11111111111
