11111111111111
1000C000000001
1111C111111011
10000000CC0C01
10C0C0C0000P01
1010101C01E001
11111111111111
