11111111
100C0011
11111111
1P00C0E1
11111111
